🔼 Position verticale et horizontale
boven → au-dessus

beneden → en bas

onder → sous / en dessous

op → sur

af → en bas de / hors de

naast → à côté de

tussen → entre

midden → au milieu

tegenover → en face de

achter → derrière

voor → devant

voorbij → au-delà de / après

aan de overkant van → de l’autre côté de

🏠 À l’intérieur et à l’extérieur
in → dans

binnen → à l’intérieur

buiten → à l’extérieur

binnenin → à l’intérieur de

buitenaf → depuis l’extérieur

binnenkant → côté intérieur

buitenkant → côté extérieur

📏 Proximité et éloignement
bij → près de

dichtbij → à proximité de

vlakbij → tout près de

ver van → loin de

in de buurt van → dans les environs de

nabij → à proximité de

➡️ Direction et mouvement
naar → vers

van → de (provenance)

uit → hors de / sorti de

over → au-dessus de / par-dessus

langs → le long de

door → à travers

rond → autour de

om → autour de

heen → autour de / en contournant

⚡ Position précise
recht voor → juste devant

recht achter → juste derrière

recht boven → directement au-dessus

recht onder → directement en dessous

vlak naast → juste à côté de

precies in het midden → exactement au milieu

🧭 Orientation droite/gauche
links → à gauche

rechts → à droite

aan de linkerkant → du côté gauche

aan de rechterkant → du côté droit

links van → à gauche de

rechts van → à droite de

📌 Autres expressions utiles
tegen → contre

tot aan → jusqu’à

binnen de grenzen van → dans les limites de

buiten de grenzen van → en dehors des limites de

in de schaduw van → à l’ombre de

in het zicht van → en vue de

